＊初期化
＄喋り間隔	１８０秒
＄喋り間隔誤差	３０％
＄会話時サーフェス戻し	有効
＄デフォルトサーフェス0	０
＄デフォルトサーフェス1	１０
＄ユーザ名	あなた
＄自動挿入ウェイトの倍率	２００％
＄自動挿入ウェイトタイプ【タブ】里々
＄なでられ持続秒数	２
＄なでられ反応回数	６０
＄トーク中のなでられ反応	無効
＄トーク乱数	０
＄散歩中	０
＄初回起動完了	０
＄消滅ボタン	1
＄消滅ボタンの状態	表示
＄ユーザ性別	男性
＄誕生月	０
＄誕生日	０
＄前回年イベント	０
＄好感度	０
＄誕生日教えた	０
＄コミュメニュータイプ	ランダム
＄前回ユーザ誕生日	０
＄プロローグ読了	０